#############
#.....#.#...#
#.....#.#...#
#.....#.#...#
#.....#.#...#
#.....#.#...#
#.....#.....#
#####....####
###........##
#########....
#.........###
#############