#############
#...........#
#...........#
#...........#
#...........#
#...........#
#...........#
#####....####
###........##
#########...#
#.........###
#############